NO ./textures/bookshelf.xpm42
SO ./textures/bricks.xpm42






WE ./textures/planks.xpm42


EA ./textures/tilledsoil.xpm42


F 0,0,255
C 255,0,255
11111
11111
10101
100N1
11111
