NO ./textures/bluestone.xpm
SO ./textures/ses.xpm
WE ./textures/socialcrd.xpm
EA ./textures/mao.xpm
F 0,0,255
C 255,0,0
11111
10001
1110111
10N01
11111111