NO ./textures/bluestone.xpm
SO ./textures/ses.xpm
WE ./textures/socialcrd.xpm
EA ./textures/mao.xpm
F 0,0,255
C 255,0,0
1  11111111
1111
 1N001
11 11