NO ./textures/bluestone.xpm
SO ./textures/ses.xpm
WE ./textures/socialcrd.xpm
EA ./textures/mao.xpm
F 0,0,255
C 255,0,0
111111111
1000000N1
111111101
      101
      101
      101
      111