NO ./textures/johnxina.xpm
SO ./textures/ses.xpm
WE ./textures/socialcrd.xpm
EA ./textures/mao.xpm
F 0,0,255
C 255,0,255
11111
10101
10N01
10001
11111
