NO ./textures/bookshelf.xpm42
SO ./textures/bricks.xpm42
WE ./textures/planks.xpm42
EA ./textures/tilledsoil.xpm42
F 220,100,99
C 255,0,2
11111
11011
10N01
11111